##########################
#.......|................#
#........................#
#........................#
#........................#
#........................#
#........................#
#........................#
#............##..........#
#........................#
#........................#
#........................#
#........................#
#....@...................$
##########################